ALARM	AH L AA R M
ASHTRAY	AE SH T R EY
CHANGE	CH EY N JH
CHECK	CH EH K
DEGREES	D IH G R IY Z
FIFTY	F IH F T IY
GOODBYE	G UH D B AY
HELLO	HH AH L OW
HELLO(2)	HH EH L OW
IS	IH Z
STEERWHEEL	S T IH ER W IY L
TEMPERATURE	T EH M P R AH CH ER
TEMPERATURE(2)	T EH M P ER AH CH ER
THE	DH AH
THE(2)	DH IY
THIRTY	TH ER D IY
TO	T UW
TO(2)	T IH
TO(3)	T AH
WHERE	W EH R
WHERE(2)	HH W EH R
